6 # 9 9 # 2 # # # # # 4 # # #
# # # # 7 8 6 # 1 2 # 3 8 6 #
5 3 # 8 3 4 9 6 # # # # # 9 #
8 5 # 7 # # # 5 # 4 # # # # #
# # # 5 9 5 3 # 5 # # # 4 8 5
2 # 8 6 1 # 7 # # 8 S # # # 4
# E 9 # # 8 4 # 3 2 7 7 # # #
8 7 5 5 # 2 8 8 2 5 7 # 9 7 #
# # # 9 # # 4 # 5 7 # # # 1 #
# 4 6 # # # 1 # 7 8 6 # 1 4 8