5 7 7 9 5 2 8 7 2 8 3 6 3 2 6 4 5 4 # 3
5 3 1 7 8 7 4 # 2 4 2 1 5 5 3 8 6 9 9 8
5 8 4 4 3 6 1 6 3 8 8 2 4 6 4 # 5 9 2 1
5 1 9 7 # 4 2 1 9 7 9 5 6 9 2 4 7 7 4 8
4 # 6 8 6 4 2 6 7 7 3 1 8 1 3 8 4 5 5 4
9 2 3 8 3 7 3 2 3 9 2 3 9 8 4 8 4 7 4 9
8 3 2 # 5 # 6 1 2 # 7 6 8 5 # 9 9 1 4 2
1 1 8 2 # S 4 # 7 6 8 7 4 1 3 8 4 2 5 8
4 3 3 # 3 3 # 3 6 # # 4 1 2 2 7 # 4 8 6
4 7 8 5 4 1 3 # 2 # 3 8 2 9 3 8 4 3 8 9
1 6 6 2 7 5 9 1 8 8 1 3 # 2 3 8 1 6 1 8
8 2 3 6 1 1 8 # 7 1 4 # 5 7 5 2 4 4 # 6
2 9 1 5 # 4 8 8 5 6 5 4 5 1 # 8 9 6 7 2
6 7 5 7 1 4 6 2 8 1 1 7 3 2 # 1 # 5 1 8
6 4 7 5 8 2 6 9 1 4 # 1 # 3 5 1 4 # 8 5
# 8 2 # 2 6 6 4 7 7 4 5 # 1 5 4 6 4 6 5
9 # 2 4 8 7 9 9 9 2 3 # 2 4 5 6 1 8 7 8
9 2 # 8 8 5 5 7 6 4 9 6 1 8 7 5 9 7 9 5
9 3 3 9 6 # 8 8 3 # 2 3 1 7 5 E 9 7 7 5
3 7 2 9 8 9 # 5 2 # 6 5 5 # 8 2 3 1 6 7