9 # 6 6 # # # 3 # #
# # 4 # 3 # # # 5 #
5 # # 5 # 5 1 1 S 9
# 1 # 9 8 # # # # 5
# 6 # # # 8 # 6 5 1
# 9 # # # 2 8 3 7 #
3 # # # # 3 # 3 4 #
E 1 # # 1 8 # 6 # 1
# 7 # 1 # 9 9 6 # 7
2 3 5 5 9 3 # 9 # #