9 7 8 4 2 1 6 6 # 6
1 4 3 # 6 8 3 7 3 6
4 3 8 1 # 9 2 1 8 4
2 7 5 5 8 # 9 1 2 4
1 9 9 4 1 5 8 7 4 #
5 # 8 4 1 4 2 6 2 E
# 7 3 # 1 8 9 8 5 9
1 3 4 # 5 # 2 3 7 1
3 8 8 8 2 1 6 7 5 9
9 8 7 1 3 2 1 S 1 2