7 7 9 5 S 7 9 7 # 4 5 6 5 6 5
5 7 6 9 # 6 2 7 9 7 9 5 # 4 5
7 5 2 4 6 1 2 7 8 8 3 3 5 5 7
9 5 9 2 # 7 8 5 4 3 1 1 5 1 1
6 9 4 2 8 6 # 8 3 8 5 5 2 # 9
7 # 4 5 7 4 6 9 # 2 # 6 7 8 9
1 5 8 2 8 1 6 # 8 7 8 3 4 1 8
# 8 4 8 1 9 4 # 5 6 4 8 3 3 1
E 9 9 3 9 # 2 6 1 8 8 4 9 9 5
2 7 1 3 1 1 # 3 # 6 4 8 6 5 5