1 # # # 6
9 6 # 5 #
# 1 E # 4
# # 1 1 #
# # 4 4 S