3 S # 3 6
4 3 6 9 2
2 6 2 3 #
# 9 E 3 1
5 4 7 2 1